####################
####################
####################
###**************###
###*^^^^^^######*###
###*^^13....####*###
###*^!40.....###*###
###*!!!2....^^##*###
###*!!..!!..^^^#*###
###*!...!!!..^^^*###
###*.....!!....!*###
###*^^^..!!..!!!*###
###*#^^^....9!!!*###
###*##^^...%@!!^*###
###*###.....$8^^*###
###*#####..^^^^^*###
###**************###
####################
####################
####################
